11111111111111111111111111
1P00C00C00C00C00C00C00C001
111C00C00C00C00C00C0111111
1110000C00C00C00C00C00C0E1
11111111111111111111111111
