1111111111
1C10100001
1101P10001
1000100E01
1111111111
